NO ./assets/textures/west.xpm
SO ./assets/textures/west.xpm
WE ./assets/textures/west.xpm
EA ./assets/textures/west.xpm

C 0,0,0
F 47,82,65

        1111111111111111111111111
        1000000000110000000000001
        1011000001110000001000001
        100100000000000001000001
111111111011000001110000000000001
100000000011000001110111110011111
11110111111111011100000010001
11110111111111011101010010001
11000000110101011100000010001
10000000000000001100000010001
10000000000000001101010010001
11000001110101011111011110N0111
11110111 1110101 101111010001
11111111 1111111 111111111111
