NO ./assets/textures/north.xpm
SO ./assets/textures/s.xpm
WE ./assets/textures/west.xpm
EA ./assets/textures/east.xpm

C 100,100,255
F 0,0,0

        1111111111111111111111111
        1000000000110000000000001
        1011000001110000000000001
        1001000000000000000000001
1111111110110000011100000000N0001
100000000011000001110111111111111
11110111111111011100000000001
11110111111111011101010000001
11000000110101011100000010001
10000000000000001100000010001111
10000000000000000001101010000001
11000001110101011101000010001111
11110111 1110101 101111010001
11111111 1111111 111111111111