NO ./assets/textures/north.xpm
SO ./assets/textures/m.xpm
WE ./assets/textures/west.xpm
EA ./assets/textures/east.xpm

C 0,0,0
F 47,82,65


        1111111111111111111111111
        1000000000000000000000001
        1001000001110000000000001
        1001000000000000000000001
1111111110010000011100000000N0001
100000000001000001110111111111111
11110111111111011100000000001
11110111111111011101010000001
11000000110000011100000010001
10000000000000001100000010001111
10000000000000000001100010000001
11000001110101011101000010001111
11110111 1110101 101111010001
11111111 1111111 111111111111
