NO ./assets/textures/west.xpm
SO ./assets/textures/west.xpm
WE ./assets/textures/west.xpm
EA ./assets/textures/west.xpm

C 0,0,0
F 47,82,65


        1111111111111111111111111
        1000000000000000000000001
        1001000001110000100000001
        1001000000000000010000001
111111111001000001110000N00000001
100000000001000001110111111111111
11110111111111011100000000001
11110111111111011101010000001
11000000110000011100000000001
10000000000000001100000000001111
10000000000000000000000000000001
11000001110101011101000010001111
11110111 1110101 101111010001
11111111 1111111 111111111111
