NO ./assets/textures/text1
SO ./assets/textures/text2
WE ./assets/textures/text3
EA ./assets/textures/text4

F 75,75,75
C 50,50,50

        1111111111111111111111111
        1000000000110000000000001
        1011000001110000000000001
        1001000000000000000000001
111111111011000001110000000000001
1000000000110000011101111111N1111
11110111111111011100000000001
11110111111111011101010000001
11000000110101011100000010001
10000000000000001100000010001111
10000000000000000001101010000001
11000001110101011101000010001111
11110111 1110101 101111010001
11111111 1111111 111111111111