NO ./assets/textures/north.xpm
SO ./assets/textures/south.xpm
WE ./assets/textures/west.xpm
EA ./assets/textures/east.xpm

C 0,0,0
F 47,82,65


11111111111111111111111111111111111111111111111111111111111111111111111111111111
100N0000000000010000000000000000000000001000000000000000000100000000000000000001
10000000000000010000000000000000000000001000000000000000000100000000000000000001
10000000000000010000000000000000000000001000000000000000000100000000000000000001
10000000000000010000000000000000000000001000000000000000000100000000000000000001
10000000000000010000000000000000000000001000000000000000000100000000000000000001
10000000000000010000000000000000000000001000000000000000000100000000000000000001
10000000000000010000000000000000000000001000000000000000000100000000000000000001
10000000000000000000000000000000000000001000000000000000000100000000000000000001
10000000000000000000000000000000000000001000000000000000000100000000000000000001
10000000000000010000000000000000000000001000000000000000000100000000000000000001
11111111111111111111111111111100111111111111111111110011111111111111111111100111
10000000000000010000000000000000000000001000000000000000000100000000000000000001
10000000000000010000000000000000000000001000000000000000000100000000000000000001
10000000000000010000000000000000000000001000000000000000000100000000000000000001
10000000000000010000000000000000000000001000000000000000000100000000000000000001
10000000000000010000000000000000000000001000000000000000000100000000000000000001
10000000000000010000000000000000000000001000000000000000000000000000000000000001
10000000000000010000000000000000000000001000000000000000000000000000000000000001
10000000000000010000000000000000000000001000000000000000000100000000000000000001
10000000000000010000000000000000000000001000000000000000000100000000000000000001
10000000000000010000000000000000000000001000000000000000000100000000000000000001
10000000000000010000000000000000000000001000000000000000000100000000000000000001
10000000000000010000000000000000000000001000000000000000000100000000000000000001
10000000000000010000000000000000000000001000000000000000000100000000000000000001
10000000000000010000000000000000000000001000000000000000000100000000000000000001
10000000000000010000000000000000000000001000000000000000000100000000000000000001
11001111111111111111111111111001111111111111001111111111111111111111111111001111
10000000000000010000000000000000000000001000000000000000000100000000000000000001
10000000000000010000000000000000000000000000000000000000000100000000000000000001
10000000000000010000000000000000000000000000000000000000000100000000000000000001
10000000000000010000000000000000000000001000000000000000000100000000000000000001
10000000000000010000000000000000000000001000000000000000000100000000000000000001
10000000000000010000000000000000000000001000000000000000000100000000000000000001
10000000000000010000000000000000000000001000000000000000000100000000000000000001
10000000000000010000000000000000000000001000000000000000000100000000000000000001
10000000000000010000000000000000000000001000000000000000000100000000000000000001
10000000000000010000000000000000000000001000000000000000000100000000000000000001
10000000000000010000000000000000000000001000000000000000000100000000000000000001
10000000000000010000000000000000000000001000000000000000000100000000000000000001
10000000000000010000000000000000000000001000000000000000000100000000000000000001
10000000000000010000000000000000000000001000000000000000000100000000000000000001
11111111111111111111111111111111111111111111111111111111111111111111111111111111